NNNNC$A$$N
C$A$C$A$$N
C$A$C$AAAN
CCCCC$A$$N
C$A$C$A$$N
C$A$C$ANNN
C$A$$$A$$N
AAAAAAA$$N
C$$$$$AN$N
CNNNN$AN$N